20 20 1200
5 5 3 1
1
....................
.A..................
....*........*......
......B.............
......*..#..........
....................
......*......*......
....................
....................
..........#.........
...............*....
........#...........
...#........***.**..
....................
......#....#........
....................
..#............*....
....................
.........*..........
....................

